boot	The Algorithm	Brute Force (Deluxe Edition)
floating point	The Algorithm	Brute Force (Deluxe Edition)
pointers	The Algorithm	Brute Force (Deluxe Edition)
brute force	The Algorithm	Brute Force (Deluxe Edition)
userspace	The Algorithm	Brute Force (Deluxe Edition)
shellcode	The Algorithm	Brute Force (Deluxe Edition)
hex	The Algorithm	Brute Force (Deluxe Edition)
deadlock	The Algorithm, Igorrr	Brute Force (Deluxe Edition)
rootkit	The Algorithm	Brute Force (Deluxe Edition)
trojans (hard mode)	The Algorithm	Brute Force (Deluxe Edition)
idle	The Algorithm	Brute Force (Deluxe Edition)
overclock	The Algorithm	Brute Force (Deluxe Edition)
double data rate synchronous dynamic random access memory	The Algorithm	Brute Force (Deluxe Edition)
floating point - Drumcorps Remix	The Algorithm, Drumcorps	Brute Force (Deluxe Edition)
runtime	The Algorithm	Brute Force (Deluxe Edition)
source code	The Algorithm	Brute Force (Deluxe Edition)
dynamic recompilation	The Algorithm	Brute Force (Deluxe Edition)
userspace - Volkor X Remix	The Algorithm, Volkor X	Brute Force (Deluxe Edition)
floating point - Vaporwave Remix	The Algorithm	Brute Force (Deluxe Edition)
rootkit - Chiptune Remix	The Algorithm	Brute Force (Deluxe Edition)
Robot Language	meganeko	Robot Language
Dream Sweet in Sea Major	Miracle Musical	Hawaii: Part II
Tessellate	soupandreas	Tessellate
Nightcall	Kavinsky	Nightcall
Where Is My Mind	Maxence Cyrin	Novö Piano
Home	AK, Mapps	Sonder
I'm Gonna Be (500 Miles)	The Proclaimers	Finest
Blessings	Chance The Rapper, Ty Dolla $ign, Anderson .Paak, BJ The Chicago Kid, Raury	Coloring Book
Little Dark Age	MGMT	Little Dark Age
Girls Like You	Denny	Girls Like You
When the World Goes Down - AK Remix	Andrew Applepie, AK	When the World Goes Down (AK Remix)
Snowman	Sia	Everyday Is Christmas
Bukowski	Modest Mouse	Good News For People Who Love Bad News
Defenestration (feat. Alexander Andersen)	Owane, Alexander Andersen	Dunno
rootkit - Chiptune Remix	The Algorithm	rootkit (Chiptune Remix)
Nomu	Good Kid	Nomu
The Man With The Skeleton Arms	Toh Kay	You By Me: Vol. 2
The Planets, Op. 32: I. Mars, the Bringer of War	Gustav Holst, Berliner Philharmoniker, Sir Colin Davis	The Dark Side of Classical Music
Don Giovanni, K. 527, Act 2: "Don Giovanni, a cenar teco m'invitasti"	Wolfgang Amadeus Mozart, Ingvar Wixell, Wladimiro Ganzarolli, Luigi Roni, Covent Garden Chorus of the Royal Opera House, Sir Colin Davis, Orchestra of the Royal Opera House, Covent Garden	The Dark Side of Classical Music
Pepper	Butthole Surfers	Electriclarryland
atom	jizue	story
All Eyes on You	St. Lucia	St. Lucia
Blackwatch Theme	Taylor Thomas	Blackwatch Theme
Savages	That Handsome Devil	History Is a Suicide Note
Lay Your Hands on Me (2017)	BOOM BOOM SATELLITES	19972016 -20082016-
Resonance	Home	Odyssey
Dirty Imbecile	The Happy Fits	Awfully Apeelin'
Cspan	Vasudeva	No Clearance
Rosa Dear	Ruth	Voilà
Carry That Weight - Remastered	The Beatles	Abbey Road (Remastered)
Kings and Queens of Wasteland	Jukio Kallio	Nuclear Throne OST
resolution	ichika	forn
Wet Sand	Red Hot Chili Peppers	Stadium Arcadium
Torture Me	Red Hot Chili Peppers	Stadium Arcadium
Black Bear	Black Bear	The Cinnamon Phase
Blast Doors	Everything Everything	Get To Heaven (Deluxe Version)
Gladion	Neku	Gladion
History	History	History
Would You Rather	Crusher-P	Would You Rather
Elsewhere	Heyrocco	Teenage Movie Soundtrack
Forever	Ykiki Beat	Forever
Iridescent	GHOST DATA	Iridescent / She Heals Everything
Leaning In	M|O|O|N	Clinically Blasé
Eulogy	Charlie Allen	Charlie Allen - EP
Have a Cigar	Pink Floyd	Wish You Were Here
The Great Gig in the Sky	Pink Floyd	The Dark Side of the Moon
House With Legs - Original Mix	cYsmix	Escapism
Echoes	Pink Floyd	Meddle
Goodbye Blue Sky	Pink Floyd	The Wall
Coming Back to Life	Pink Floyd	The Division Bell
Iridescent	GHOST DATA, AVANNA, Luka Megurine	Iridescent / She Heals Everything
Kites	Grynpyret	Kites
Who Knows?	weird inside	As We Know
Hydrogen	M|O|O|N	Moon - EP
And Here's to Many More	Sithu Aye	Cassini (5th Anniversary Remaster)
Haunt Me	Samsa	Haunt Me
High Seas & Childish Dreams	iMAGiN8	High Seas And Childish Dreams EP
Way It Goes	Hippo Campus	Landmark
Colors - Sam Feldt Remix	Halsey, Sam Feldt	Complementary Colors
Carnivore	Bear Attack!	Epochs
Affection	Ivory City	Affection
Dive In	KYKO	Dive In
Sugar Glider	omniboi	Nice Dream
Lonely	The Maine	Lovely Little Lonely
Red Balloon	Deal Casino	Deal Casino
Lay Your Hands on Me (Feat. Zenpaku) [Extended]	dj-Jo, Zenpaku	Lay Your Hands on Me (Remixes) [Extended]
Things in Life	Nameless Warning	Things in Life
Isle Unto Thyself	Miracle Musical	Hawaii: Part II
SGL	Now, Now	SGL
Cannibal	Tally Hall	Good & Evil
Line Without A Hook	Ricky Montgomery	Montgomery Ricky
Better Than Me	The Brobecks	Violent Things
Bloom	Denny	Bloom
Only Human	Chipzel	Spectra
Empyrean	meganeko	Technokinesis
Firelight	Kubbi	Ember
In One Piece	Tennyson	In One Piece
Conscious	Broods	Conscious
Pyrokinesis	Clairity	Pyrokinesis
Christmas Kids	Roar	I Can't Handle Change
Still Bored	Pheeno	How It Is EP
Ab Ovo	Joep Beving	Ab Ovo
On & On	Plts	On & On
What Will Become of Us	Aether	As She Fell Through the Stars
Hopeless	Halsey, Cashmere Cat	hopeless fountain kingdom (Deluxe)
The Curious Disappearance of the Sky-ship Thunder Man	Bryan Scary & the Shredding Tears	Flight of the Knife
Great Escape	Brick + Mortar	Dropped Again
Claudia	She, in the haze	Mama said
Mad World	UNSECRET, REMMI	Mad World
begin again	Purity Ring	another eternity
Like a Star	Mike Krol	I Hate Jazz
Pumped up Kids	Fundamentally Sound	Uncle Murgatroyd's Music Box
Fifteen Minutes	Mike Krol	I Hate Jazz
Vacation	Crying	Get Olde / Second Wind
Love Like You (End Credits)	Steven Universe, Rebecca Sugar	Steven Universe, Vol. 1 (Original Soundtrack)
Strange Town	The Moderates	Colour
Fourth of July	King Washington	The Gears
Big Dater	Big Data	2.0
Home (Keygen Flip) [From "Undertale"]	Ephixa, GameChops	Home (Keygen Flip) [From "Undertale"]
Coming Home	Seven Lions, Mike Mains	Creation
I'll Remember April	Miles Davis	Blue Haze
Where We Used To Live	Esbjörn Svensson Trio	Tuesday Wonderland
Blackbeak	Youngblood Hawke	Wake Up
At Least I Have Nothing	Saint Motel	Voyeur
Getsomerest/sleepwell	Quickly Quickly	Quickly Quickly, Vol. 1
Frost	Germany Germany	Reconnect
The Boy Who Flew	Modulogeek	Modulogeek
Superseded (feat. Adam Tell)	Simpli, Adam Tell	Superseded
Set on Fire (Prototyperaptor Remix)	MAGIC GIANT, Prototyperaptor	Set on Fire (Prototyperaptor Remix)
Young And Beautiful	Lana Del Rey	Young And Beautiful
Traveling at the Speed of Light	Joywave	How Do You Feel Now?
Genghis Khan	Miike Snow	iii
Sunshine	Dorian	Sunshine
Woods of Mystery - Remix	Theophany	Time's End II: Majora's Mask (Music Inspired by the Game) (Remixes)
A Sadness Runs Through Him	The Hoosiers	The Trick To Life
The Bleeding of Mercy	Telepathic Teddy Bear	The Course of Empire
Where Is My Mind	Telepathic Teddy Bear	Where Is My Mind
Once Upon a Time	GENTLE LOVE	Prescription for Sleep: Undertale
We Talk Like Machines	Savoir Adore	In The Wooded Forest
Feel Good Inc	IRONTOM	Feel Good Inc
Billie Jean	EDEN	Billie Jean
Whisper	Burn The Ballroom	Melodies for the Outsiders
After All	Dar Williams	Many Great Companions
Castles In The Snow	Twin Shadow	Forget
Inescapable You	The Moderates	Colour
Bloodstream	Transviolet	Transviolet
Geek in the Pink	The UNCG Spartones	RansomNotes Volume 1
Jai Ho	Washington University Stereotypes	Tongue Tied
God Only Knows	JR JR, Dale Earnhardt Jr Jr	Horse Power EP
Stardust	Amarante	Enchanting The Siren
Roses	Deon Custom	Roses
Delfino Plaza	Qumu	Delfino Plaza
Next Year - RAC Remix	Two Door Cinema Club	Next Year
First	Cold War Kids	Hold My Home
Why Do I Keep Counting?	The Killers	Sam's Town
My Tears Are Becoming A Sea	M83	Hurry Up, We're Dreaming
For Elise	Saint Motel	saintmotelevision
When You Were Young - Piano Version	A Silent Film	Sam's Town (Piano Versions)
Her (Loving You)	Glades	Her (Loving You)
Ég byrja reisu mín	Gunnar Gunnarsson, Sigurður Flosason	Icelandic Hymns
Blumenkranz	Sapphire	Don't Lose Your Way (Kill la Kill)
Angel By The Wings	Sia	Angel By The Wings
Piano Dentist	Stepcat	The Jitterbug EP
Selfish	The Reverb Junkie	All I Want
Grav Lift - Original Mix	Pheeno	Installation 01
Agnes	Glass Animals	How To Be A Human Being
More Like Jason	Little Tybee	Little Tybee
Uma	Panama Wedding	Parallel Play
Sharks In The Swimming Pool - The Noisy Freaks Remix	Clairity	Sharks In The Swimming Pool (The Noisy Freaks Remix)
Bad Habits	FIDLAR	Too
The Hymn of Acxiom	Vienna Teng	Aims
Focus	Chipzel	Super Hexagon
The Fix Is In	OK Go	OK Go
Invincible	OK Go	Oh No
Beneath the Brine	The Family Crest	Beneath The Brine
Wolves (You Got Me)	DREAMERS	This Album Does Not Exist
Run Dry (X Heart X Fingers)	Patrick Stump	Soul Punk (Deluxe Edition)
A Better Son/Daughter	Rilo Kiley	The Execution Of All Things
The Warnings Part II	David Axelrod	Earth Rot
Yin Yang	USS (Ubiquitous Synergy Seeker)	Advanced Basics
Set On Fire - Demo	MAGIC GIANT	Magic Giant
Filter This	Clover the Girl	Filter This
Beach Bones (feat. Ryan Ross)	More Amor	Beach Bones (feat. Ryan Ross)
Greyhound	Swedish House Mafia	Until Now
Water	Ra Ra Riot, Rostam	Need Your Light
LA Devotee	Panic! At The Disco	Death Of A Bachelor
Technicolour	Daniella Mason	Technicolour
Paradise	Clementine and the Galaxy	Paradise
Cravings	VOKES	Fractalism - EP
The World Could Always Use More Heroes (Overwatch Remix)	GameChops, Curly	The World Could Always Use More Heroes (Overwatch Remix)
The Nearness Of You	Bill Charlap	Stardust: The Music Of Hoagy Carmichael
The Truth of Violence	Telepathic Teddy Bear	The Course of Empire
Hollow Tune	Brick + Mortar	Dropped
Ebb + Flow	Kylaido	Ebb + Flow - Single
End Credits	EDEN, Leah Kelly	End Credits
Alright Goodnight	Heirs	Ecliptic
Lost Boy	Ruth B.	Lost Boy
Aurora Borealis (Luca Lush Remix)	The Griswolds, Luca Lush	Aurora Borealis (Luca Lush Remix)
Undercover	Hive Riot	Hive Riot
Catch	Dresses	Let Down
Undone	the bird and the bee	Undone
God Only Knows	Flint Eastwood	Small Victories
Broke	Bear Attack!	Broke
Take Me Out	Golden State	Take Me Out
Latch	Vanderbilt Melodores	M
I'll Die	My Double, My Brother	Shelves
Thunder At	Caleb Groh	Ocelot
Falling Faster	Andrew Ripp	Andrew Ripp
Overflow	Ghost Loft	Overflow
Bridge and the Wall	Elohim	Elohim
Glass Heart	MAGIC GIANT	Magic Giant
Far Hills Cider	VHS Collection	VHS Collection
Blueless Bird	Joni Fatora	Navigator EP
Uncruel	House of Lions	Uncruel
Ghosts	Alagoas	Alagoas
Tell It All	Bossie	Tell It All
Lights Out	AudioDamn!	AudioDamn!
Real Lies (Vourtsanis Remix)	Faded Paper Figures	Remnants - EP
On The Wire	Air Traffic Controller	On The Wire
Can't Stop, Gotta Date With Hate	lostprophets	Liberation Transmission
Dead!	My Chemical Romance	The Black Parade (Explicit Version)
Famous Last Words	My Chemical Romance	The Black Parade (Explicit Version)
Underdog	Sly & The Family Stone	A Whole New Thing
Genesis	Justice	Justice
White Walls	The Maine	Forever Halloween
Run	The Maine	Forever Halloween
Take What You Can Carry	The Maine	Forever Halloween
Say Hello (feat. Saidah Conrad)	Free n Losh, Saidah Conrad	Say Hello (feat. Saidah Conrad)
This Year	Cooper	This Year
Good Girl	Julian Moon	Good Girl
First Time	Icona Pop	Emergency EP
Altar	Poppy	Bubblebath
Fallen Down	GameChops, Holder	Undertale Remixed
Asgore (Undertale Remix)	GameChops, dj-Jo	Asgore (Undertale Remix)
Bonetrousle	GameChops, Holder	Undertale Remixed
Spider Dance	GameChops, Holder	Undertale Remixed
Dark World (Legend of Zelda Remix)	James Landino, GameChops, Smooth McGroove	Smooth McGroove Remixed
Hyrule Dungeon (Courage)	James Landino, GameChops	Link to the Future
Enough (feat. M. Maggie)	Black Coast, M. Maggie	Enough (feat. M. Maggie)
Search Party	Sam Bruno	I AM SAM PT. 1
Your Future is Not Mine (Illangelo Remix) [feat. Joseph of Mercury]	DAISY, Joseph of Mercury	Your Future is Not Mine (Illangelo Remix) [feat. Joseph of Mercury]
Fire Alarm	Castlecomer	Fire Alarm
River from the Sky	The Weepies	Sirens
New Gravity	Lil Bub	Science & Magic: A Soundtrack to the Universe
Nights Like This	W. Darling	Chapter One
Habits (Stay High)	Tove Lo	Queen Of The Clouds (Blueprint Edition)
Habits	Scott Bradlee's Postmodern Jukebox, Haley Reinhart	Selfies on Kodachrome
Start This Fire	The Royal Foundry	Start This Fire
Night Vision	Transviolet	Transviolet
Help Our Souls	NIHILS	Help Our Souls
Someone to Watch Over Me	The Duke's Men	The Works
Helplessness Blues	The Duke's Men	The Works
Attack	Conway	Conway
Lose It	Oh Wonder	Oh Wonder
Technicolour Beat	Oh Wonder	Oh Wonder
Reflection	Sugafish	Reflection
Renegades	X Ambassadors	VHS
Downtown (feat. Melle Mel, Grandmaster Caz, Kool Moe Dee & Eric Nally)	Macklemore & Ryan Lewis, Grandmaster Caz, Grandmaster Melle Mel, Eric Nally, Kool Moe Dee	This Unruly Mess I've Made
Hero	Family of the Year	Loma Vista
Nature Boy	The Whiffenpoofs	The Best Whiffenpoofs Ever
Violet	Hippo Campus	South
Don't Panic	Clairity	Don't Panic
It Can't Rain Forever	Oh Honey	Wish You Were Here - EP
It's Only A Dream	Modern Space	Before Sunrise
Long Way Down	Robert DeLong	In The Cards
Control	Halsey	BADLANDS
Drive	Halsey	BADLANDS
Fire	Diskopunk	Fire
Swim	Fickle Friends	Swim
Take Me To Church (Acoustic Cover) feat. Matt Wright	Megan Davies	Take Me To Church (Acoustic Cover) feat. Matt Wright
See You Again, Love Me Like You Do, Sugar - Acoustic Mashup	Megan Davies	See You Again, Love Me Like You Do, Sugar (Acoustic Mashup)
Want to Want Me [Acoustic Cover]	Megan Davies, Kyle Nachtigal	Want to Want Me [Acoustic Cover]
March: Hills to Climb	Tim Myers	The Year
Shark in the Water	The Cocktails	Another Round
Burn	Voices in Your Head	Burn - Single
Overture	AJR	Living Room
Love and Stuff	Eahnor	Fear, Change, Breathe and Repeat
Stressed Out	Twenty One Pilots	Blurryface
Black Lips	The Zephyr Bones	Black Lips B/W Surrounded by Sunflowers
Everybody Wants To Rule The World - From “The Hunger Games: Catching Fire” Soundtrack	Lorde	The Hunger Games: Catching Fire (Original Motion Picture Soundtrack / Deluxe Version)
Everybody Wants to Rule the World	Ninja Sex Party	Under the Covers
Jumpclub	Barrio Jazz Gang	Barrio Jazz Gang, Vol. 2
Raise the Dead	Caravan of Thieves	The Funhouse
Horns	Bryce Fox	Horns
Color	Finish Ticket	When Night Becomes Day
2AM	Bear Hands	You'll Pay For This
Free	Broods	Free
Superhero (feat. Mc Little Tree)	Kormac, Mc Little Tree	Doorsteps
Ride	Twenty One Pilots	Blurryface
Rock Bottom	Hailee Steinfeld, DNCE	HAIZ
The Less I Know The Better	Tame Impala	Currents
Beat Of My Drum	POWERS	Legendary
The Sound	The 1975	I like it when you sleep, for you are so beautiful yet so unaware of it
Dancing On Glass	St. Lucia	Dancing On Glass
Drive	Glades	Drive
Winterbreak	MUNA	Winterbreak
Temporary Love	The Brinks	Temporary Love
101	WALLA	101
Sing It Back	Swing Republic, Karina Kappel	Mo' Electro Swing Republic - Let's Misbehave
Payin' Dues (feat. Willdabeast)	Ageless, Willdabeast	I'm Gone
Mr Mambo (Hips Mix)	11 Acorn Lane	Time for Tea
One Bratha to Another	Funky Destination	Revolution Is Only Solution
Undertale	Zach Boucher	Undertale
Undertale (Music Box)	Jayn	Undertale (Music Box)
Indelible and Nocturnal	Wynton Marsalis	Standard Time Vol. 2: Intimacy Calling
All or Nothing (feat. Tanya Morgan & Lorine Chia)	Guts, Lorine Chia, Tanya Morgan	Eternal
Megalovania	Tsuko G.	Undertale Kazoo'd!
Megalovania	GameChops, Holder	Undertale Remixed
Pony	Deluxe	Polishing Peanuts EP
Stay The Same	Bonobo, Andreya Triana	Black Sands
All In Forms	Bonobo	Black Sands
El Toro	Bonobo	Black Sands
Kiara	Bonobo	Black Sands
Swinging in the Rain	Nicolas Repac	Swing-Swing
Mermaid - Original Mix	Electronic Swing Orchestra	Mermaid
Swing and Bounce	Deep East Music	Boogie Bop Swing Things
In The Search Of The Truth - Radio Edit	JK Soul	Universal Love EP
Tiki Suite Pt. 1 - Cuban Casbah	The Bahama Soul Club	The Cuban Tapes
Midnight	Caravan Palace	<|º_º|>
I'm the Boss	Big Bad Bosses	Power Overwhelming
Crazy in Love - Electro Swing Version	Swing Republic, Karina Kappel	Crazy in Love
Lone Digger	Caravan Palace	<|º_º|>
I'll Rust With You	Steam Powered Giraffe	Mk III
Nantes	Beirut	The Flying Club Cup
Work from Home	Fifth Harmony, Ty Dolla $ign	7/27 (Deluxe)
I'll Form the Head	MC Frontalot	Solved
The New Year	Random Forest	Hibernation
Gymnopedie	Emile Pandolfi	Believe
Fireflies	Violents	Red Lights
Chandelier	Twisted Measure	Chandelier
Part of That Strange Dream	Daniel Hart	Comet (Original Motion Picture Soundtrack)
Welcome, Ghosts	Explosions In The Sky	All of a Sudden I Miss Everyone
The Birth And Death Of The Day	Explosions In The Sky	All of a Sudden I Miss Everyone
Runaway	AURORA	All My Demons Greeting Me As A Friend (Deluxe Version)
Cannonball	Skylar Grey, X Ambassadors	Cannonball
Fire and the Flood	Vance Joy	Dream Your Life Away (Special Edition)
Habits (Stay High)	Young Rising Sons	The High EP
Oasis	A Great Big World	When the Morning Comes
Wild Things	Alessia Cara	Know-It-All (Deluxe)
Easy Way (Acapella)	For The Foxes	Summer Nights
I'm Good	The Mowgli's	Kids In Love
Underground (Live)	Cody Fry	Live Captured Recordings
Another Night On Mars	The Maine	American Candy
Papercut	Zedd, Troye Sivan	True Colors
Salt	B.Miles	Twenty Fifteen
Magic Bullet	Jacob Whitesides	Faces on Film
Saint Valentine	Gregory Alan Isakov	The Weatherman
Girls Your Age	Transviolet	Transviolet
Show Your Colors	Genevieve	Show Your Colors
Let's Get Started	Dylan Gardner	Adventures In Real Time
Me Liquor and God	Night Beds	Ivywild
The Dance	Family of the Year	Family of the Year
El Sonidito	Hechizeros Band	El Sonidito
Alice	Bianca Ryan	Alice
Stay / Animal Mashup	Jessica Rotter, Emily Colombier	Stay / Animal Mashup
Cecilia And The Satellite	Andrew McMahon in the Wilderness	Andrew McMahon In The Wilderness
Préludes, Op. 28: No. 15 in D-Flat Major, "Raindrops"	Frédéric Chopin, Nikita Magaloff	Chopin - The One and Only
Impromptu No. 4 in C sharp Minor, Op. 66 "Fantaisie-Impromptu"	Frédéric Chopin, Julius Katchen	Chopin - The One and Only
Waltzes, Op. 64: No. 1 in D-Flat Major, "Minute Waltz"	Frédéric Chopin, Nikita Magaloff	Chopin - The One and Only
Metamorphosis: Metamorphosis Five	Philip Glass	Solo Piano
Klaunstance	Charlie Parker	Parker's Mood
Bird Gets the Worm	Charlie Parker	Parker's Mood
Parker's Mood	Charlie Parker	Parker's Mood
Merry Go Round	Charlie Parker	Parker's Mood
Chi Chi	Charlie Parker Quartet, Charlie Parker	In Person
Daft Punk	Pentatonix	PTX, Vol. 2
Strawberry Bubblegum	Justin Timberlake	The 20/20 Experience
I Get a Kick Out of You	Charlie Parker, Cole Porter	In Person
Bravado	Lorde	Pure Heroine (Extended)
What Kind Of Man	Florence + The Machine	What Kind Of Man
Weathered	Jack Garratt	Phase (Deluxe)
Fly to Paradise - Main Mix	Eric Whitacre, Guy Sigsworth, Hila Plitmann, Will Dawes	Fly to Paradise
Bridges	Broods	Evergreen
Interstellar - First Step	Kyle Landry	Interstellar - First Step
Dream A Little Dream Of Me	Ella Fitzgerald, Louis Armstrong	Ella & Friends
What You Know	Two Door Cinema Club	Tourist History
The Throne Room / End Title - From "Star Wars: A New Hope"	John Williams, London Symphony Orchestra	Star Wars Sampler
Wavin' Flag	Bruin Harmony	Voices Only 2011 College A Cappella (Volume 1)
Inflammatus et accensus	Gioachino Rossini, Montserrat Caballé, Carlo Felice Cillario	Donizetti, Rossini, Verdi: Rarities
Savannah	Tufts Beelzebubs	In The Book
Ain't It Fun	Tufts Beelzebubs	In The Book
Creep	Straight No Chaser	The New Old Fashioned (Deluxe)
Nude	University of North Carolina Clef Hangers	Voices Only 2010 College A Cappella (Disc 2)
Come Sail Away	Tufts Beelzebubs	PandæMonium
Counting Stars	The Nor'easters	Counting Stars - Single
Animal	University of North Carolina Clef Hangers	BOCA 2012: Best Of College A Cappella
Everybody Talks	Tufts Beelzebubs	BOCA 2014: Best Of College A Cappella
Becalmed	Arturo Stalteri	coolAugustMoon - From The Music Of Brian Eno
Hymnals	Grizfolk	From The Spark
Intro	The xx	xx
Hooked on a Feeling	Blue Swede, Björn Skifs	Hooked On A Feeling
Sing For Your Supper	The Mamas & The Papas	Gold
Threnody	Goldmund	The Malady Of Elegance
Ignition / Do You... (Mashup)	Phoebe Ryan	Mine EP
I Don't Like It, I Love It (feat. Robin Thicke & Verdine White)	Flo Rida, Robin Thicke, Verdine White	MY HOUSE
Illuminate	The Kite String Tangle, Dustin Tebbutt	Illuminate
Hide and Seek	transit vocal band	Transit
Come Home	CHAPPO	Plastique Universe
Electric Feel	MGMT	Oracular Spectacular
Little Numbers	BOY	Mutual Friends
Sweet Disposition	The Temper Trap	Conditions
Tongue Tied	Grouplove	Never Trust A Happy Song
Cool Kids	Echosmith	Talking Dreams (Deluxe Version)
Thinking Out Loud	Jasmine Thompson	Thinking Out Loud
Saint Claude (Version Française)	Christine and the Queens	Chaleur Humaine
Tear In My Heart	Twenty One Pilots	Blurryface
Pony	Pretty Sister	Now // Later
Be Easy	Ghost Loft	Be Easy
Are U There?	Mura Masa	Someday Somewhere
Human - Marian Hill Remix	Aquilo	Human (Marian Hill Remix)
Get Good (Infinitefreefall Remix)	St. South	Get Good (Infinitefreefall Remix)
